S8889.........&&
.&&&6.^^.7889.&&
.&&&6.^^.6..6.&&
.7223.^^.6..6.&&
.4&&&....6..6.&&
.4&&&&&&&6..6.&&
.122222223..6...
............122E
&&&&&&&&&&&.....